0 0 0 0 0 0 0 0 0 0 0 0 0 0 0 0 0 0 0 0 0 0 0 0 0 0 0 0 0 0 
0 0 0 0 0 0 0 0 0 0 0 0 0 0 0 0 0 0 0 0 0 0 0 0 0 0 0 0 0 0 
0 0 0 0 0 0 0 0 0 0 0 0 0 0 0 0 0 0 0 0 0 0 0 0 0 0 0 0 0 0 
0 0 0 0 0 0 0 0 0 0 0 0 0 0 0 0 0 0 0 0 0 0 0 0 0 0 0 0 0 0 
0 0 0 0 0 0 0 0 0 0 0 0 0 0 0 0 0 0 0 0 0 0 0 0 0 0 0 0 0 0 
0 0 0 0 0 0 0 0 14 14 14 14 14 14 14 14 14 14 14 14 1 1 0 0 0 0 0 0 0 0
0 0 0 0 0 0 0 0 14 14 14 14 14 14 14 14 14 14 14 14 14 1 0 0 0 0 0 0 0 0 
0 0 0 0 0 0 0 0 14 14 14 14 14 14 14 14 14 14 14 14 14 1 0 0 0 0 0 0 0 0 
0 0 0 0 0 0 0 0 14 14 14 14 14 14 14 14 14 14 14 14 14 14 0 0 0 0 0 0 0 0
0 0 0 0 0 0 0 0 14 14 14 14 14 14 14 14 14 14 14 14 14 14 0 0 0 0 0 0 0 0
0 0 0 0 0 0 0 0 14 14 14 14 14 14 14 14 14 14 14 14 14 14 0 0 0 0 0 0 0 0 
0 0 0 0 0 0 0 0 14 14 14 14 14 14 14 14 0 14 14 14 14 14 0 0 0 0 0 0 0 0
0 0 0 0 0 0 0 0 14 14 14 14 14 14 14 0 0 0 14 14 14 14 0 0 0 0 0 0 0 0
0 0 0 0 0 0 0 0 14 14 14 14 14 14 14 0 0 0 0 0 14 14 0 0 0 0 0 0 0 0 
11 11 11 11 11 11 11 11 14 14 14 14 14 14 0 0 0 0 0 0 14 14 0 0 0 0 0 0 0 0 
11 11 11 11 11 11 11 11 14 14 14 14 14 14 14 0 0 0 0 0 14 14 14 0 0 0 0 0 0 0 0
0 0 0 0 0 0 0 0 14 14 14 14 14 14 14 0 0 0 0 14 14 14 0 0 0 0 0 0 0 0 
0 0 0 0 0 0 0 0 14 14 14 14 14 14 14 14 0 0 0 14 14 14 0 0 0 0 0 0 0 0 
0 0 0 0 0 0 0 0 14 14 14 14 14 14 14 14 14 14 14 14 14 14 0 0 0 0 0 0 0 0 
0 0 0 0 0 0 0 0 14 14 14 14 14 14 14 14 14 14 14 14 14 14 0 0 0 0 0 0 0 0 
0 0 0 0 0 0 0 0 14 14 14 14 14 14 14 14 14 14 14 14 14 14 0 0 0 0 0 0 0 0
0 0 0 0 0 0 0 0 14 14 14 14 14 14 14 14 14 14 14 14 14 14 0 0 0 0 0 0 0 0
0 0 0 0 0 0 0 0 14 14 14 14 14 14 14 14 14 14 14 14 14 14 0 0 0 0 0 0 0 0
0 0 0 0 0 0 0 0 14 14 14 14 14 14 14 14 14 14 14 14 14 14 0 0 0 0 0 0 0 0
0 0 0 0 0 0 0 0 14 14 14 14 14 14 14 14 14 14 14 14 14 14 0 0 0 0 0 0 0 0 
0 0 0 0 0 0 0 0 0 0 0 0 0 0 0 0 0 0 0 0 0 0 0 0 0 0 0 0 0 0 
0 0 0 0 0 0 0 0 0 0 0 0 0 0 0 0 0 0 0 0 0 0 0 0 0 0 0 0 0 0 
0 0 0 0 0 0 0 0 0 0 0 0 0 0 0 0 0 0 0 0 0 0 0 0 0 0 0 0 0 0 
0 0 0 0 0 0 0 0 0 0 0 0 0 0 0 0 0 0 0 0 0 0 0 0 0 0 0 0 0 0 
0 0 0 0 0 0 0 0 0 0 0 0 0 0 0 0 0 0 0 0 0 0 0 0 0 0 0 0 0 0 