0 0 0 0 0 0 0 0 0 0 0 0 0 0 0 0 0 0 0 0 11 11 0 0 0 0 0 0 0 0 0 0 0 0 0 0 0 0 0 0
0 0 0 0 0 0 0 0 0 0 0 0 0 0 0 0 0 0 0 0 11 11 0 0 0 0 0 0 0 0 0 0 0 0 0 0 0 0 0 0
0 0 0 0 0 0 0 0 0 0 0 0 0 0 0 0 0 0 0 0 11 11 0 0 0 0 0 0 0 0 0 0 0 0 0 0 0 0 0 0
0 0 0 0 0 0 0 0 0 0 0 0 0 0 0 0 0 0 0 0 11 11 0 0 0 0 0 0 0 0 0 0 0 0 0 0 0 0 0 0
0 0 0 0 0 0 0 0 0 0 0 0 0 0 0 0 0 0 0 0 11 11 0 0 0 0 0 0 0 0 0 0 0 0 0 0 0 0 0 0
0 0 0 0 0 0 0 6 3 3 3 3 3 3 3 3 3 3 3 3 12 12 3 3 3 3 3 3 3 3 3 3 4 0 0 0 0 0 0 0
0 0 0 0 0 0 0 5 13 13 13 13 13 13 13 13 13 13 13 13 12 12 13 13 13 13 13 13 13 13 13 13 7 0 0 0 0 0 0 0
0 0 0 0 0 0 0 5 13 13 13 13 13 13 13 13 13 13 13 13 12 12 13 13 13 13 13 13 13 13 13 13 7 0 0 0 0 0 0 0
0 0 0 0 0 0 0 5 13 13 13 13 13 13 13 13 13 13 13 13 12 12 13 13 13 13 13 13 13 13 13 13 7 0 0 0 0 0 0 0
0 0 0 0 0 0 0 5 13 13 13 13 13 13 13 13 13 13 13 13 12 12 13 13 13 13 13 13 13 13 13 13 7 0 0 0 0 0 0 0
0 0 0 0 0 0 0 5 13 13 13 13 12 12 13 13 13 13 13 13 12 12 13 13 13 13 13 13 13 13 13 13 7 0 0 0 0 0 0 0
0 0 0 0 0 0 0 5 13 13 13 13 12 12 12 12 12 12 12 12 12 12 12 12 12 12 12 12 13 13 13 13 7 0 0 0 0 0 0 0
0 0 0 0 0 0 0 5 13 13 13 13 12 12 12 12 12 12 12 12 12 12 12 12 12 12 12 12 13 13 13 13 7 0 0 0 0 0 0 0
0 0 0 0 0 0 0 5 13 13 13 13 13 13 13 13 13 13 13 13 12 12 13 13 13 13 13 13 13 13 13 13 7 0 0 0 0 0 0 0
0 0 0 0 0 0 0 5 13 13 13 13 13 13 13 13 13 13 13 13 12 12 13 13 13 13 13 13 13 13 13 13 7 0 0 0 0 0 0 0
0 0 0 0 0 0 0 5 13 13 13 13 13 13 13 13 13 13 13 13 12 12 13 13 13 13 13 13 13 13 13 13 7 0 0 0 0 0 0 0
0 0 0 0 0 0 0 5 13 13 13 13 13 13 13 13 13 13 13 13 12 12 13 13 13 13 13 13 13 13 13 13 7 0 0 0 0 0 0 0
0 0 0 0 0 0 0 5 13 13 13 13 13 13 13 13 13 13 13 13 12 12 13 13 13 13 13 13 13 13 13 13 7 0 0 0 0 0 0 0
0 0 0 0 0 0 0 5 13 13 13 13 13 13 13 13 13 13 13 13 12 12 13 13 13 13 13 13 13 13 13 13 7 0 0 0 0 0 0 0
11 11 11 11 11 11 11 12 12 12 12 12 12 12 12 12 12 12 12 12 12 12 12 12 12 12 12 12 12 12 12 12 12 11 11 11 11 11 11 11
11 11 11 11 11 11 11 12 12 12 12 12 12 12 12 12 12 12 12 12 12 12 12 12 12 12 12 12 12 12 12 12 12 11 11 11 11 11 11 11
0 0 0 0 0 0 0 5 13 13 13 13 13 13 13 13 13 13 13 13 12 12 13 13 13 13 13 13 13 13 13 13 7 0 0 0 0 0 0 0
0 0 0 0 0 0 0 5 13 13 13 13 13 13 13 13 13 13 13 13 12 12 13 13 13 13 13 13 13 13 13 13 7 0 0 0 0 0 0 0
0 0 0 0 0 0 0 5 13 13 13 13 13 13 13 13 13 13 13 13 12 12 13 13 13 13 13 13 13 13 13 13 7 0 0 0 0 0 0 0
0 0 0 0 0 0 0 5 13 13 13 13 13 13 13 13 13 13 13 13 12 12 13 13 13 13 13 13 13 13 13 13 7 0 0 0 0 0 0 0
0 0 0 0 0 0 0 5 13 13 13 13 13 13 13 13 13 13 13 13 12 12 13 13 13 13 13 13 13 13 13 13 7 0 0 0 0 0 0 0
0 0 0 0 0 0 0 5 13 13 13 13 13 12 12 12 12 12 12 12 12 12 12 12 12 12 12 12 13 13 13 13 7 0 0 0 0 0 0 0
0 0 0 0 0 0 0 5 13 13 13 13 13 12 12 12 12 12 12 12 12 12 12 12 12 12 12 12 13 13 13 13 7 0 0 0 0 0 0 0
0 0 0 0 0 0 0 5 13 13 13 13 13 13 13 13 13 13 13 13 12 12 13 13 13 13 13 13 13 13 13 13 7 0 0 0 0 0 0 0
0 0 0 0 0 0 0 5 13 13 13 13 13 13 13 13 13 13 13 13 12 12 13 13 13 13 13 13 13 13 13 13 7 0 0 0 0 0 0 0
0 0 0 0 0 0 0 5 13 13 13 13 13 13 13 13 13 13 13 13 12 12 13 13 13 13 13 13 13 13 13 13 7 0 0 0 0 0 0 0
0 0 0 0 0 0 0 5 13 13 13 13 13 13 13 13 13 13 13 13 12 12 13 13 13 13 13 13 13 13 13 13 7 0 0 0 0 0 0 0
0 0 0 0 0 0 0 5 13 13 13 13 13 13 13 13 13 13 13 13 12 12 13 13 13 13 13 13 13 13 13 13 7 0 0 0 0 0 0 0
0 0 0 0 0 0 0 5 13 13 13 13 13 13 13 13 13 13 13 13 12 12 13 13 13 13 13 13 13 13 13 13 7 0 0 0 0 0 0 0
0 0 0 0 0 0 0 5 13 13 13 13 13 13 13 13 13 13 13 13 12 12 13 13 13 13 13 13 13 13 13 13 7 0 0 0 0 0 0 0
0 0 0 0 0 0 0 2 1 1 1 1 1 1 1 1 1 1 1 1 13 13 1 1 1 1 1 1 1 1 1 1 8 0 0 0 0 0 0 0
0 0 0 0 0 0 0 0 0 0 0 0 0 0 0 0 0 0 0 0 11 11 0 0 0 0 0 0 0 0 0 0 0 0 0 0 0 0 0 0
0 0 0 0 0 0 0 0 0 0 0 0 0 0 0 0 0 0 0 0 11 11 0 0 0 0 0 0 0 0 0 0 0 0 0 0 0 0 0 0
0 0 0 0 0 0 0 0 0 0 0 0 0 0 0 0 0 0 0 0 11 11 0 0 0 0 0 0 0 0 0 0 0 0 0 0 0 0 0 0
0 0 0 0 0 0 0 0 0 0 0 0 0 0 0 0 0 0 0 0 11 11 0 0 0 0 0 0 0 0 0 0 0 0 0 0 0 0 0 0