15 15 15 15 15 15 15 15 15 15 15 15 15 15 
15 15 15 15 15 15 15 15 15 15 15 15 15 15
15 15 12 12 12 12 12 12 12 12 12 12 15 15
15 15 12 12 12 12 12 12 12 12 12 12 15 15
15 15 12 12 12 12 12 12 12 12 12 12 15 15
15 15 12 12 12 12 12 12 12 12 12 12 15 15
15 15 12 12 12 12 12 12 12 12 12 12 15 15
15 15 12 12 12 12 12 12 12 12 12 12 15 15
15 15 12 12 12 12 12 12 12 12 12 12 15 15
15 15 12 12 12 12 12 12 12 12 12 12 15 15
15 15 12 12 12 12 12 12 12 12 12 12 15 15
15 15 12 12 12 12 12 12 12 12 12 12 15 15
15 15 15 15 15 15 12 12 15 15 15 15 15 15
15 15 15 15 15 15 15 15 15 15 15 15 15 15